1111111111
1P00CE0101
1000C0C101
1111111111