111111111111111
11C0000000000E1
110111111111111
10000CC000000P1
111111111111111