1111111111111111111111111
100000C000P000000000000E1
1000000000000000000000001
1111111111111111111111111