1111111111111111111111111
1000100000000000010100001
100010001000C000001000001
1000100010000000000000001
1000100111111100000000001
1000100000000100000000001
1000100000001111111111C11
100010000C000000011111001
1000010000000000001000001
10000010001111000010P0001
10000010010C0100001101111
100C001C000001000010C0001
10000011111111C0001000001
1000000000C00000001000001
1111111111111111111111111
